SO ../assets/purplestone.xpm
NO ../assets/wood.xpm
WE ../assets/azanane.xpm
EA ../assets/eagle.xpm
F 70, 70, 70
C 150, 150,230

1111111111111111111111111
1000000000000000000000001
1000000000000000000000001
1000000000000010000000001
1000000000000001000000001
1000010000000000100000001
1000010000000000010000001
1000010000000000000000001
1000010000000000000100001
10000000000N0000000100001
1000010000000011111111101
1000000000000000000100001
1000010000010000000100001
1000000000010000000000001
1000010000010000000000001
1000001111111100000000001
1000000000000000000000001
1000000000000000000000001
1111111111111111111111111
