SO ./path_to_the_south_texture
NO ./path_to_the_north_texture
WE ./path_to_the_west_texture
EA ./path_to_the_east_texture
F 220,100,0
C 225,30,0
1111111111111111111111111
1000000000110000000000001
1011000001110000100000001
100100000000000000000000111111111
1111111110110000011100000000000W1
100000000011000001110111111111111
11110111111111011100000010001
11110011111111011101010010001
110000001101010111000010000011
1000000000000000000001 10000001
10000000000000000001001000001001
1100000111010101111101000000111
  110111 1110101 101111010001
  111111 1111111 111111111111
